#####
#. .#
#$ $#
#@  #
#####

######
#    #
# .$$#
# $$+#
#. *.#
######

######
#. ..#
# $@.#
# $$$#
#    #
######

######
# $..#
# $@$#
# .$ #
#   .#
######

######
#    #
#$$. #
#@#$ #
#..  #
######

######
#.$ .#
# @$ #
#$#. #
#    #
######

######
#   .#
#.$* #
# $.$#
#@   #
######

######
#. *.#
#.$$@#
#  *$#
#    #
######

######
#  $+#
#  **#
#  $ #
# $..#
######

######
# $+.#
#  $*#
#  $ #
#  *.#
######