
####
#--#####
#-.--$-#
#-$--.@#
###--###
--####

####
#--#####
#-.--$-#
#-$--.@#
###--###
--####

62  13 63 34 44 5242 3242 21 11