
####
#--#####
#-.--$-#
#-$--.@#
###--###
--####


--####
--#--#
###--###
#-$*.@-#
#------#
########


--####
###--#
#--*@#
#--$.##
###---#
--#---#
--#####


-#######
##-@---#
#-$.---#
#-.$####
##--#
-#--#
-####


--####
--#--#
###--#
#---@##
#-*$.-#
###---#
--#####


--####
--#--#
--#--#
###-@##
#-*$.-#
#-----#
##--###
-####


--######
--#----#
###----#
#---@###
#-*$.#
###--#
--####


-######
-#----#
##$-.-#
#--@--#
#-$#.-#
#--####
####


####
#--#
#-@#
#.$###
#----#
#.$#-#
##---#
-#####


--####
###--#
#--$@#
#--$-##
###---#
--#-..#
--#####


########
#-.$@--#
#--$-.-#
###--###
--#--#
--####


--####
--#--#
###--###
#-$$-@-#
#----..#
########


--#####
###---#
#--.@-#
#-$$--#
##.-###
-#--#
-####


-####
-#--#
-#-.#
##$@#
#-$-####
#--.---#
####---#
---#####


-#####
-#---#
##---#
#-$$##
#..@#
#--##
#--#
####


-#######
##-.---#
#-$*$--#
#--.@###
#----#
######


--####
--#--###
###.$.-#
#--$.$-#
#---@###
#----#
######


--####
--#--#
--#--#
###$.#
#-@.$##
#-#$.-#
#-----#
#######


--####
--#--#
###--#
#--*-#
#@.*$##
##-*--#
-#----#
-######


-####
-#--#
-#--#
-#--####
###$$--#
#---.*@#
#---.###
######


-####
-#--###
-#-...#
##$---#
#-$-###
#-$-#
#--@#
#####


-#######
##--.--#
#-*$$--#
#-#@-###
#-.--#
######


#####
#---#
#---####
##$$-$-#
-#+.-.-#
-#--####
-#--#
-####


########
#--#---#
#------#
#$$$####
#+.-.#
######


#######
#---..#
#-$-@.#
##$$--#
-#--###
-#--#
-####


--####
--#--#
###--###
#-$-*$-#
#-.@-.-#
##---###
-#####


####
#--#
#--#####
#-$$-$-#
#@..-.-#
##--####
-#--#
-####


#######
#---.@###
#--***--#
#---$---#
######--#
-----####


